caca	/kaka/
canard	/kanɑɔ̯ʁ/
cinq	/sãɪ̯̃k/
elles	/i/
fa	/fa/
guenille	/genij/
guenilles	/genij/
il	/i/
ils	/i/
kung-fu	/kɔŋfu/
la	/la/
ma	/ma/
moi	/mwɛ/
papa	/papa/
sa	/sa/
ta	/ta/
ticket	/t͡sɪkat/, /t͡sɪka/
tofu	/tɑɔ̯fy/
toi	/twɛ/
à cette heure	/astœʁ/
être	/aɛ̯t/
