à cause que	/akozkə/
acéricole	/aseʁikɔl/
acéricoles	/aseʁikɔl/
acériculteur	/aseʁɪkʏltœʁ/
acériculteurs	/aseʁɪkʏltœʁ/
acéricultrice	/aseʁikyltʁis/
acéricultrices	/aseʁikyltʁis/
acériculture	/aseʁɪkʏlt͡sʏʁ/
acéricultures	/aseʁɪkʏlt͡sʏʁ/
achala	/aʃalɔ/
achalai	/aʃale/
achalaient	/aʃala/
achalais	/aʃala/
achalait	/aʃala/
achalâmes	/aʃalam/
achalant	/aʃalæ̃/
achalas	/aʃalɔ/
achalasse	/aʃalas/
achalassent	/aʃalas/
achalasses	/aʃalas/
achalassiez	/aʃalasje/
achalassions	/aʃalasjõũ̯/
achalât	/aʃalɔ/
achalâtes	/aʃalat/
achale	/aʃal/
achalé	/aʃale/
achalent	/aʃal/
achalera	/aʃalʁɔ/
achaler	/aʃale/
achalerai	/aʃalʁe/
achaleraient	/aʃalʁa/
achalerais	/aʃalʁa/
achalerait	/aʃalʁa/
achaleras	/aʃalʁɔ/
achalèrent	/aʃalaʁ/
achalerez	/aʃalʁe/
achaleriez	/aʃaləʁje/
achalerions	/aʃaləʁjõũ̯/
achalerons	/aʃalʁõũ̯/
achaleront	/aʃalʁõũ̯/
achales	/aʃal/
achalez	/aʃale/
achaliez	/aʃalje/
achalions	/aʃaljõũ̯/
achalons	/aʃalõũ̯/
achigan	/aʃɪɡæ̃/
achigans	/aʃɪɡæ̃/
arena	/aʁɛna/
arenas	/aʁɛna/
asteur	/astœʁ/
asteure	/astœʁ/
astheure	/astœʁ/
astinage	/ast͡sɪnaʒ/
astinages	/ast͡sɪnaʒ/
astiner	/ast͡sɪne/
astineuse	/ast͡sɪnøz/
astineuses	/ast͡sɪnøz/
astineux	/ast͡sɪnø/
babiche	/babɪʃ/
babiches	/babɪʃ/
baboune	/babʊn/
babouner	/babʊne/
babounes	/babʊn/
bacaisse	/bakas/
bacaisses	/bakas/
backer	/bake/
badloqué	/badlɑɔ̯ke/
badloquée	/badlɑɔ̯ke/
badloquées	/badlɑɔ̯ke/
badloqués	/badlɑɔ̯ke/
badlucké	/badlʊke/
badluckée	/badlʊke/
badluckées	/badlʊke/
badluckés	/badlʊke/
balloune	/balʊn/
ballounes	/balʊn/
baloune	/balʊn/
balounes	/balʊn/
banc de neige	/bɑ̃dənaʒ/
barbotine	/baʁbɑɔ̯t͡sɪn/
barbotines	/baʁbɑɔ̯t͡sɪn/
bardasser	/baʁdase/
bargainer	/baʁɡane/
barganne	/baʁɡan/
bargannes	/baʁɡan/
bébelle	/bebal/
bébelles	/bebal/
bécosse	/bekɑɔ̯s/
bécosses	/bekɑɔ̯s/
bibitte	/bɪbit/
bibittes	/bɪbit/
bidou	/bɪdu/
bidous	/bɪdu/
blaster	/blaste/
blé d’Inde	/bledẽĩ̯d/
bleuetière	/bløt͡sjaʁ/
bobet	/bɑɔ̯ba/
bobets	/bɑɔ̯ba/
bobette	/bɑɔ̯bat/
bobettes	/bɑɔ̯bat/
boîte à malle	/bwatamal/
boîtes à malle	/bwatamal/
bouscueil	/bʊskœj/
brake	/bʁɛk/
braker	/bʁɛke/
brakes	/bʁɛk/
broue	/bʁu/
bum	/bɑɔ̯m/
bumper	/bœmpəʁ/
bumpers	/bœmpəʁ/
bums	/bɑɔ̯m/
cabane à sucre	/kabanasʏk/
cacaoui	/kakawi/
cacaouis	/kakawi/
caleur	/kalœʁ/
caleurs	/kalœʁ/
caleuse	/kaløz/
caleuses	/kaløz/
caller	/kole/
Canayen	/kanajẽĩ̯/
Canayenne	/kanajan/
Canayennes	/kanajan/
Canayens	/kanajẽĩ̯/
canceler	/kɑ̃sle/
canceller	/kɑ̃sle/
carcajou	/kaʁkaʒu/
carcajous	/kaʁkaʒu/
carreautée	/kaʁote/
carreautées	/kaʁote/
carreauté	/kaʁote/
carreautés	/kaʁote/
cenne	/san/
cennes	/san/
centre d'achats	/sãũ̯tdaʃa/
champelure	/ʃɑ̃plʏʁ/
champelures	/ʃɑ̃plʏʁ/
champlure	/ʃɑ̃plʏʁ/
champlures	/ʃɑ̃plʏʁ/
checkaient	/tʃaka/
checkais	/tʃaka/
checkai	/tʃake/
checkait	/tʃaka/
checkâmes	/tʃakam/
checkant	/tʃakæ̃/
checkassent	/tʃakas/
checkasses	/tʃakas/
checkasse	/tʃakas/
checkassiez	/tʃakasje/
checkassions	/tʃakasjõũ̯/
checkas	/tʃakɔ/
checka	/tʃakɔ/
checkâtes	/tʃakat/
checkât	/tʃakɔ/
checkent	/tʃak/
checkeraient	/tʃakʁa/
checkerais	/tʃakʁa/
checkerai	/tʃakʁe/
checkerait	/tʃakʁa/
checkeras	/tʃakʁɔ/
checkera	/tʃakʁɔ/
checkèrent	/tʃakaʁ/
checkerez	/tʃakʁe/
checkeriez	/tʃakəʁje/
checkerions	/tʃakəʁjõũ̯/
checkerons	/tʃakʁõũ̯/
checkeront	/tʃakʁõũ̯/
checker	/tʃake/, /tʃeke/
checkes	/tʃak/
checke	/tʃak/
checké	/tʃake/
checkez	/tʃake/
checkiez	/tʃakje/
checkions	/tʃakjõũ̯/
checkons	/tʃakõũ̯/
chéquer	/tʃeke/
chercheure	/ʃaʁʃœʁ/
chialeuse	/ʃjɑløz/
chialeuses	/ʃjɑløz/
chialeux	/ʃjɑlø/
chien chaud	/ʃjẽĩ̯ʃo/
chien-chaud	/ʃjẽĩ̯ʃo/
chien chauds	/ʃjẽĩ̯ʃo/
chien-chauds	/ʃjẽĩ̯ʃo/
chums	/tʃɔm/
chum	/tʃɔm/
chus	/ʃy/, /ʃys/
clairaient	/klaʁa/
clairai	/klaʁe/
clairais	/klaʁa/
clairait	/klaʁa/
claira	/klaʁɔ/
clairâmes	/klaʁam/
clairant	/klaʁæ̃/
clairas	/klaʁɔ/
clairasse	/klaʁas/
clairassent	/klaʁas/
clairasses	/klaʁas/
clairassiez	/klaʁasje/
clairassions	/klaʁasjõũ̯/
clairâtes	/klaʁat/
clairât	/klaʁɔ/
claire	/klaʁ/
clairé	/klaʁe/
clairent	/klaʁ/
claireraient	/klaʁəʁa/
clairerai	/klaʁəʁe/
clairerais	/klaʁəʁa/
clairerait	/klaʁəʁa/
clairera	/klaʁəʁɔ/
claireras	/klaʁəʁɔ/
clairèrent	/klaʁaʁ/
clairerez	/klaʁəʁe/
claireriez	/klaʁəʁje/
clairerions	/klaʁəʁjõũ̯/
clairer	/klaʁe/
clairerons	/klaʁəʁõũ̯/
claireront	/klaʁəʁõũ̯/
claires	/klaʁ/
clairez	/klaʁe/
clairiez	/klaʁje/
clairions	/klaʁjõũ̯/
clavardaient	/klavaʁda/
clavardai	/klavaʁde/
clavardais	/klavaʁda/
clavardait	/klavaʁda/
clavarda	/klavaʁdɔ/
clavardâmes	/klavaʁdam/
clavardant	/klavaʁdæ̃/
clavardas	/klavaʁdɔ/
clavardasse	/klavaʁdas/
clavardassent	/klavaʁdas/
clavardasses	/klavaʁdas/
clavardassiez	/klavaʁdasje/
clavardassions	/klavaʁdasjõũ̯/
clavardâtes	/klavaʁdat/
clavardât	/klavaʁdɔ/
clavarde	/klavaʁd/
clavardé	/klavaʁde/
clavardent	/klavaʁd/
clavarderaient	/klavaʁdəʁa/
clavarderai	/klavaʁdəʁe/
clavarderais	/klavaʁdəʁa/
clavarderait	/klavaʁdəʁa/
clavardera	/klavaʁdəʁɔ/
clavarderas	/klavaʁdəʁɔ/
clavardèrent	/klavaʁdaʁ/
clavarderez	/klavaʁdəʁe/
clavarderiez	/klavaʁdəʁje/
clavarderions	/klavaʁdəʁjõũ̯/
clavarder	/klavaʁde/
clavarderons	/klavaʁdəʁõũ̯/
clavarderont	/klavaʁdəʁõũ̯/
clavardes	/klavaʁd/
clavardez	/klavaʁde/
clavardiez	/klavaʁd͡zje/
clavardions	/klavaʁd͡zjõũ̯/
clavardons	/klavaʁdõũ̯/
cossin	/kɑɔ̯sẽĩ̯/
cossins	/kɑɔ̯sẽĩ̯/
costume de bain	/kɑɔ̯st͡sʏm də bẽĩ̯/
costumes de bain	/kɑɔ̯st͡sʏm də bẽĩ̯/
crampaient	/kʁɑ̃pa/
crampai	/kʁɑ̃pe/
crampais	/kʁɑ̃pa/
crampait	/kʁɑ̃pa/
crampa	/kʁɑ̃pɔ/
crampâmes	/kʁɑ̃pam/
crampant	/kʁɑ̃pæ̃/
crampas	/kʁɑ̃pɔ/
crampasse	/kʁɑ̃pas/
crampassent	/kʁɑ̃pas/
crampasses	/kʁɑ̃pas/
crampassiez	/kʁɑ̃pasje/
crampassions	/kʁɑ̃pasjõũ̯/
crampâtes	/kʁɑ̃pat/
crampât	/kʁɑ̃pɔ/
crampé	/kʁɑ̃pe /
crampent	/kʁãũ̯p/
cramperaient	/kʁɑ̃pəʁa/
cramperai	/kʁɑ̃pəʁe/
cramperais	/kʁɑ̃pəʁa/
cramperait	/kʁɑ̃pəʁa/
crampera	/kʁɑ̃pəʁɔ/
cramperas	/kʁɑ̃pəʁɔ/
crampèrent	/kʁɑ̃paʁ/
cramperez	/kʁɑ̃pəʁe/
cramperiez	/kʁɑ̃pəʁje/
cramperions	/kʁɑ̃pəʁjõũ̯/
cramper	/kʁɑ̃pe/
cramperons	/kʁɑ̃pəʁõũ̯/
cramperont	/kʁɑ̃pəʁõũ̯/
crampez	/kʁɑ̃pe/
crampiez	/kʁɑ̃pje/
crampions	/kʁɑ̃pjõũ̯/
crosseur	/kʁɔsaœ̯ʁ/
crosseurs	/kʁɔsaœ̯ʁ/
crosseuse	/kʁɑɔ̯søz/
crosseuses	/kʁɑɔ̯søz/
cruiser	/kʁuze/, /kʁuzœʁ/
cruisers	/kʁuzœʁ/
cute	/kjʊt/
débarra	/debaʁɔ/
débarrai	/debaʁe/
débarraient	/debaʁa/
débarrais	/debaʁa/
débarrait	/debaʁa/
débarrâmes	/debaʁam/
débarrant	/debaʁæ̃/
débarrât	/debaʁɔ/
débarrâtes	/debaʁat/
débarre	/debaʁ/
débarré	/debaʁe/
débarrée	/debaʁe/
débarrent	/debaʁ/
débarrera	/debaʁəʁɔ/
débarrerai	/debaʁəʁe/
débarreraient	/debaʁəʁa/
débarrerais	/debaʁəʁa/
débarrerait	/debaʁəʁa/
débarreras	/debaʁəʁɔ/
débarrer	/debaʁe/
débarrèrent	/debaʁaʁ/
débarrerez	/debaʁəʁe/
débarreriez	/debaʁəʁje/
débarrerions	/debaʁəʁjõũ̯/
débarrerons	/debaʁəʁõũ̯/
débarreront	/debaʁəʁõũ̯/
débarres	/debaʁ/
débarrez	/debaʁe/
débarriez	/debaʁje/
débarrions	/debaʁjõũ̯/
débarrons	/debaʁõũ̯/
docteure	/dɑɔ̯ktœʁ/
draft	/dʁaft/
drafts	/dʁaft/
dret	/dʁa/
drets	/dʁa/
drette	/dʁat/
drettes	/dʁat/
enfirouapa	/ɑ̃fɪʁwapɔ/
enfirouapaient	/ɑ̃fɪʁwapa/
enfirouapai	/ɑ̃fɪʁwape/
enfirouapais	/ɑ̃fɪʁwapa/
enfirouapait	/ɑ̃fɪʁwapa/
enfirouapâmes	/ɑ̃fɪʁwapam/
enfirouapant	/ɑ̃fɪʁwapæ̃/
enfirouapas	/ɑ̃fɪʁwapɔ/
enfirouapasse	/ɑ̃fɪʁwapas/
enfirouapassent	/ɑ̃fɪʁwapas/
enfirouapasses	/ɑ̃fɪʁwapas/
enfirouapassiez	/ɑ̃fɪʁwapasje/
enfirouapassions	/ɑ̃fɪʁwapasjõũ̯/
enfirouapâtes	/ɑ̃fɪʁwapat/
enfirouapât	/ɑ̃fɪʁwapɔ/
enfirouape	/ɑ̃fɪʁwap/
enfirouapé	/ɑ̃fɪʁwape/
enfirouapent	/ɑ̃fɪʁwap/
enfirouapera	/ɑ̃fɪʁwapʁɔ/
enfirouaperaient	/ɑ̃fɪʁwapʁa/
enfirouaperai	/ɑ̃fɪʁwapʁe/
enfirouaperais	/ɑ̃fɪʁwapʁa/
enfirouaperait	/ɑ̃fɪʁwapʁa/
enfirouaperas	/ɑ̃fɪʁwapʁɔ/
enfirouapèrent	/ɑ̃fɪʁwapaʁ/
enfirouaperez	/ɑ̃fɪʁwapʁe/
enfirouaper	/ɑ̃fiʁwɑpe/
enfirouaperiez	/ɑ̃fɪʁwapəʁje/
enfirouaperions	/ɑ̃fɪʁwapəʁjõũ̯/
enfirouaperons	/ɑ̃fɪʁwapʁõũ̯/
enfirouaperont	/ɑ̃fɪʁwapʁõũ̯/
enfirouapes	/ɑ̃fɪʁwap/
enfirouapez	/ɑ̃fɪʁwape/
enfirouapiez	/ɑ̃fɪʁwapje/
enfirouapions	/ɑ̃fɪʁwapjõũ̯/
enfirouapons	/ɑ̃fɪʁwapõũ̯/
envoye	/ãvwaj/, /ãvwɛj/
envoye-donc	/ãvwajdɔ̃/
épinglette	/epẽĩ̯glεt/
érablière	/eʁabljaʁ/
faire la baboune	/faʁlababʊn/
farce plate 	/faʁsplat/
farces plates	/faʁsplat/
fin de semaine	/fẽĩ̯dəsman/
fins de semaine	/fẽĩ̯dəsman/
flasheur	/flaʃøʁ/
flat	/flat/
flusher	/flœʃe/
flyée	/flaje/
flyées	/flaje/
flyé	/flaje/
flyés	/flaje/
foufoune	/fʊfʊn/
foufounes	/fʊfʊn/
frencha	/fʁantʃɔ/
frenchaient	/fʁantʃa/
frenchai	/fʁantʃe/
frenchais	/fʁantʃa/
frenchait	/fʁantʃa/
frenchâmes	/fʁantʃam/
frenchant	/fʁantʃæ̃/
frenchas	/fʁantʃɔ/
frenchasse	/fʁantʃas/
frenchassent	/fʁantʃas/
frenchasses	/fʁantʃas/
frenchassiez	/fʁantʃasje/
frenchassions	/fʁantʃasjõũ̯/
frenchâtes	/fʁantʃat/
frenchât	/fʁantʃɔ/
frenche	/fʁantʃ/
frenché	/fʁantʃe/
frenchent	/fʁantʃ/
frenchera	/fʁantʃəʁɔ/
frencheraient	/fʁantʃəʁa/
frencherai	/fʁantʃəʁe/
frencherais	/fʁantʃəʁa/
frencherait	/fʁantʃəʁa/
frencheras	/fʁantʃəʁɔ/
frenchèrent	/fʁantʃaʁ/
frencherez	/fʁantʃəʁe/
frencher	/fʁantʃe/
frencheriez	/fʁantʃəʁje/
frencherions	/fʁantʃəʁjõũ̯/
frencherons	/fʁantʃəʁõũ̯/
frencheront	/fʁantʃəʁõũ̯/
frenches	/fʁantʃ/
frenchez	/fʁantʃe/
frenchiez	/fʁantʃje/
frenchions	/fʁantʃjõũ̯/
frenchons	/fʁantʃõũ̯/
frette	/fʁat/
frettes	/fʁat/
fun	/fɔn/
game	/ɡam/
games	/ɡam/
garrocha	/ɡaʁɑɔ̯ʃɔ/
garrochage	/ɡaʁɔʃaʒ/
garrochai	/ɡaʁɑɔ̯ʃe/
garrochaient	/ɡaʁɑɔ̯ʃa/
garrochais	/ɡaʁɑɔ̯ʃa/
garrochait	/ɡaʁɑɔ̯ʃa/
garrochâmes	/ɡaʁɑɔ̯ʃam/
garrochant	/ɡaʁɑɔ̯ʃæ̃/
garrochas	/ɡaʁɑɔ̯ʃɔ/
garrochasse	/ɡaʁɑɔ̯ʃas/
garrochassent	/ɡaʁɑɔ̯ʃas/
garrochasses	/ɡaʁɑɔ̯ʃas/
garrochassiez	/ɡaʁɑɔ̯ʃasje/
garrochassions	/ɡaʁɑɔ̯ʃasjõũ̯/
garrochât	/ɡaʁɑɔ̯ʃɔ/
garrochâtes	/ɡaʁɑɔ̯ʃat/
garroche	/ɡaʁɑɔ̯ʃ/
garroché	/ɡaʁɑɔ̯ʃe/
garrochée	/gaʁɔʃe/
garrochées	/gaʁɔʃe/
garroché	/gaʁɔʃe/
garrochent	/ɡaʁɑɔ̯ʃ/
garrochera	/ɡaʁɑɔ̯ʃʁɔ/
garrocherai	/ɡaʁɑɔ̯ʃʁe/
garrocheraient	/ɡaʁɑɔ̯ʃʁa/
garrocherais	/ɡaʁɑɔ̯ʃʁa/
garrocherait	/ɡaʁɑɔ̯ʃʁa/
garrocher	/ɡaʁɑɔ̯ʃe/
garrocheras	/ɡaʁɑɔ̯ʃʁɔ/
garrochèrent	/ɡaʁɑɔ̯ʃaʁ/
garrocherez	/ɡaʁɑɔ̯ʃʁe/
garrocheriez	/ɡaʁɑɔ̯ʃəʁje/
garrocherions	/ɡaʁɑɔ̯ʃəʁjõũ̯/
garrocherons	/ɡaʁɑɔ̯ʃʁõũ̯/
garrocheront	/ɡaʁɑɔ̯ʃʁõũ̯/
garroches	/ɡaʁɑɔ̯ʃ/
garrochés	/gaʁɔʃe/
garrochez	/ɡaʁɑɔ̯ʃe/
garrochiez	/ɡaʁɑɔ̯ʃje/
garrochions	/ɡaʁɑɔ̯ʃjõũ̯/
garrochons	/ɡaʁɑɔ̯ʃõũ̯/
giguer	/ʒiɡe/
gigueuses	/ʒigøz/
gigueuse	/ʒigøz/
gigueux	/ʒigø/
gomme à mâcher	/gɑɔ̯mamɑʃe/
gossante	/ɡɑɔ̯sãũ̯t/
gossantes	/ɡɑɔ̯sãũ̯t/
gossant	/ɡɑɔ̯sæ̃/
gossants	/ɡɑɔ̯sæ̃/
gougoune	/gʊgʊn/
gougounes	/gʊgʊn/
gouverneure générale	/ɡuvaʁnœʁ ʒeneʁal/
gouverneures générales	/ɡuvaʁnœʁ ʒeneʁal/
gratteuse	/ɡʁatøz/
gratteuses	/ɡʁatøz/
gratteux	/ɡʁatø/
greyé	/ɡʁaje/
greyer	/ɡʁaje/
gréyer	/ɡʁeje/
hoods	/ud/
hood	/ud/
huart	/ʼyaʁ/
icitte	/isɪt/
joke	/dʒok/
kétaine	/ketan/
kétaines	/ketan/
magané	/maɡane/
maganer	/maɡane/
maïs éclaté	/maɪseklate/
maïs soufflé	/maɪssʊfle/
matcher	/matʃe/
moé	/mwɛ/
mop	/mɔp/
moppe	/mɔp/
mopper	/mɔpe/
mops	/mɔp/
mouffette	/mʊfat/
mouffettes	/mʊfat/
mouver	/mʊve/
napkin	/napkɪn/
napkins	/napkɪn/
névasse	/nevas/
névasses	/nevas/
noliser	/nɑɔ̯lɪze/
nono	/nɑɔ̯no/
nonos	/nɑɔ̯no/
ostineuse	/ɑɔ̯st͡sɪnøz/
ostineuses	/ɑɔ̯st͡sɪnøz/
ostineux	/ɑɔ̯st͡sɪnø/
ouatcher	/watʃe/
pantoute	/pãtut/
paquetée	/pakte/
paquetées	/pakte/
paqueté	/pakte/
paquetés	/pakte/
parlure	/paʁlʏʁ/
parlures	/paʁlʏʁ/
parties	/paʁte/
party	/paʁte/
partys	/paʁte/
pas d’allure	/padalʏʁ/
pas pire	/pɑpiʁ/
pâte à dents	/pɑtadã/
pâtes à dents	/pɑtadã/
peinturaient	/pẽĩ̯t͡sʏʁa/
peinturai	/pẽĩ̯t͡sʏʁe/
peinturais	/pẽĩ̯t͡sʏʁa/
peinturait	/pẽĩ̯t͡sʏʁa/
peinturâmes	/pẽĩ̯t͡sʏʁam/
peinturant	/pẽĩ̯t͡sʏʁæ̃/
peintura	/pẽĩ̯t͡sʏʁɔ/
peinturas	/pẽĩ̯t͡sʏʁɔ/
peinturassent	/pẽĩ̯t͡sʏʁas/
peinturasse	/pẽĩ̯t͡sʏʁas/
peinturasses	/pẽĩ̯t͡sʏʁas/
peinturassiez	/pẽĩ̯t͡sʏʁasje/
peinturassions	/pẽĩ̯t͡sʏʁasjõũ̯/
peinturâtes	/pẽĩ̯t͡sʏʁat/
peinturât	/pẽĩ̯t͡sʏʁɔ/
peinturent	/pẽĩ̯t͡sʏʁ/
peinturé	/pẽĩ̯t͡sʏʁe/
peintureraient	/pẽĩ̯t͡sʏʁəʁa/
peinturerai	/pẽĩ̯t͡sʏʁəʁe/
peinturerais	/pẽĩ̯t͡sʏʁəʁa/
peinturerait	/pẽĩ̯t͡sʏʁəʁa/
peinturera	/pẽĩ̯t͡sʏʁəʁɔ/
peintureras	/pẽĩ̯t͡sʏʁəʁɔ/
peinturèrent	/pẽĩ̯t͡sʏʁaʁ/
peinturerez	/pẽĩ̯t͡sʏʁəʁe/
peintureriez	/pẽĩ̯t͡sʏʁəʁje/
peinturerions	/pẽĩ̯t͡sʏʁəʁjõũ̯/
peinturerons	/pẽĩ̯t͡sʏʁəʁõũ̯/
peintureront	/pẽĩ̯t͡sʏʁəʁõũ̯/
peinturer	/pẽĩ̯t͡sʏʁe/
peinturez	/pẽĩ̯t͡sʏʁe/
peinturiez	/pẽĩ̯t͡sʏʁje/
peinturions	/pẽĩ̯t͡sʏʁjõũ̯/
peinturons	/pẽĩ̯t͡sʏʁõũ̯/
piasse	/pjas/
picaouin	/pɪkawɪn/
pinotte	/pɪnɑɔ̯t/
pinottes	/pɪnɑɔ̯t/
pitcher	/pɪtʃe/
pitchers	/pɪtʃe/
pitoune	/pɪtʊn/
pitounes	/pɪtʊn/
placotaient	/plakɑɔ̯ta/
placotai	/plakɑɔ̯te/
placotais	/plakɑɔ̯ta/
placotait	/plakɑɔ̯ta/
placotâmes	/plakɑɔ̯tam/
placotant	/plakɑɔ̯tæ̃/
placota	/plakɑɔ̯tɔ/
placotas	/plakɑɔ̯tɔ/
placotassent	/plakɑɔ̯tas/
placotasse	/plakɑɔ̯tas/
placotasses	/plakɑɔ̯tas/
placotassiez	/plakɑɔ̯tasje/
placotassions	/plakɑɔ̯tasjõũ̯/
placotâtes	/plakɑɔ̯tat/
placotât	/plakɑɔ̯tɔ/
placotent	/plakɑɔ̯t/
placote	/plakɑɔ̯t/
placoté	/plakɑɔ̯te/
placoteraient	/plakɑɔ̯tʁa/
placoterai	/plakɑɔ̯tʁe/
placoterais	/plakɑɔ̯tʁa/
placoterait	/plakɑɔ̯tʁa/
placotera	/plakɑɔ̯tʁɔ/
placoteras	/plakɑɔ̯tʁɔ/
placotèrent	/plakɑɔ̯taʁ/
placoterez	/plakɑɔ̯tʁe/
placoteriez	/plakɑɔ̯təʁje/
placoterions	/plakɑɔ̯təʁjõũ̯/
placoterons	/plakɑɔ̯tʁõũ̯/
placoteront	/plakɑɔ̯tʁõũ̯/
placoter	/plakɑɔ̯te/
placotes	/plakɑɔ̯t/
placotez	/plakɑɔ̯te/
placotiez	/plakɑɔ̯t͡sje/
placotions	/plakɑɔ̯t͡sjõũ̯/
placotons	/plakɑɔ̯tõũ̯/
platte	/plat/
plattes	/plat/
plogue	/plɑɔ̯ɡ/
ploguer	/plɑɔ̯ɡe/
pognaient	/pɑɔ̯ɲa/
pognai	/pɑɔ̯ɲe/
pognais	/pɑɔ̯ɲa/
pognait	/pɑɔ̯ɲa/
pognâmes	/pɑɔ̯ɲam/
pognant	/pɑɔ̯ɲæ̃/
pogna	/pɑɔ̯ɲɔ/
pognas	/pɑɔ̯ɲɔ/
pognassent	/pɑɔ̯ɲas/
pognasse	/pɑɔ̯ɲas/
pognasses	/pɑɔ̯ɲas/
pognassiez	/pɑɔ̯ɲasje/
pognassions	/pɑɔ̯ɲasjõũ̯/
pognâtes	/pɑɔ̯ɲat/
pognât	/pɑɔ̯ɲɔ/
pognent	/pɑɔ̯ɲ/
pogné	/pɑɔ̯ɲe/
pogneraient	/pɑɔ̯ɲʁa/
pognerai	/pɑɔ̯ɲʁe/
pognerais	/pɑɔ̯ɲʁa/
pognerait	/pɑɔ̯ɲʁa/
pognera	/pɑɔ̯ɲʁɔ/
pogneras	/pɑɔ̯ɲʁɔ/
pognèrent	/pɑɔ̯ɲaʁ/
pognerez	/pɑɔ̯ɲʁe/
pogneriez	/pɑɔ̯ɲəʁje/
pognerions	/pɑɔ̯ɲəʁjõũ̯/
pogner les nerfs	/pɑɔ̯ɲelenaʁ/
pognerons	/pɑɔ̯ɲʁõũ̯/
pogneront	/pɑɔ̯ɲʁõũ̯/
pogner	/pɑɔ̯ɲe/
pognez	/pɑɔ̯ɲe/
pogniez	/pɑɔ̯ɲje/
pognions	/pɑɔ̯ɲjõũ̯/
poquaient	/pɑɔ̯ka/
poquai	/pɑɔ̯ke/
poquais	/pɑɔ̯ka/
poquait	/pɑɔ̯ka/
poquâmes	/pɑɔ̯kam/
poquant	/pɑɔ̯kæ̃/
poqua	/pɑɔ̯kɔ/
poquas	/pɑɔ̯kɔ/
poquassent	/pɑɔ̯kas/
poquasse	/pɑɔ̯kas/
poquasses	/pɑɔ̯kas/
poquassiez	/pɑɔ̯kasje/
poquassions	/pɑɔ̯kasjõũ̯/
poquâtes	/pɑɔ̯kat/
poquât	/pɑɔ̯kɔ/
poquent	/pɑɔ̯k/
poque	/pɑɔ̯k/
poqué	/pɑɔ̯ke/
poqueraient	/pɑɔ̯kʁa/
poquerai	/pɑɔ̯kʁe/
poquerais	/pɑɔ̯kʁa/
poquerait	/pɑɔ̯kʁa/
poquera	/pɑɔ̯kʁɔ/
poqueras	/pɑɔ̯kʁɔ/
poquèrent	/pɑɔ̯kaʁ/
poquerez	/pɑɔ̯kʁe/
poqueriez	/pɑɔ̯kəʁje/
poquerions	/pɑɔ̯kəʁjõũ̯/
poquerons	/pɑɔ̯kʁõũ̯/
poqueront	/pɑɔ̯kʁõũ̯/
poquer	/pɑɔ̯ke/
poques	/pɑɔ̯k/
poquez	/pɑɔ̯ke/
poquiez	/pɑɔ̯kje/
poquions	/pɑɔ̯kjõũ̯/
poquons	/pɑɔ̯kõũ̯/
portager	/pɑɔ̯ʁtaʒe/
poteux	/pɔtø/
potteux	/pɔtø/
poutine	/pʊt͡sɪn/
poutines	/pʊt͡sɪn/
prélart	/pʁelaʁ/
première ministre	/pʁəmjaʁ mɪnis/
premières ministres	/pʁəmjaʁ mɪnis/
professeure	/pʁɑɔ̯fasœʁ/
quétaine	/ketan/
quétaines	/ketan/
quêteux	/katø/
raconteux	/ʁakõũ̯tø/
relish	/ʁəlɪʃ/
relishs	/ʁəlɪʃ/
robine	/ʁɑɔ̯bɪn/
robines	/ʁɑɔ̯bɪn/
robineuse	/ʀɑɔ̯bɪnøz/
robineuses	/ʀɑɔ̯bɪnøz/
robineux	/ʀɑɔ̯bɪnø/
roteux	/ʁɑɔ̯tø/
sacrer son camp	/sakresõũ̯kæ̃/
se ploguer	/səplɑɔ̯ɡe/
se pogner le cul	/səpɑɔ̯ɲeləky/
slaquer	/slake/
sloche	/slɔʃ/
slush	/slɔʃ/
solage	/sɑɔ̯laʒ/
solages	/sɑɔ̯laʒ/
spotter	/spɑɔ̯tœʁ/, /spɑɔ̯te/
spotters	/spɑɔ̯tœʁ/
swing la bacaisse	/swɪŋlabakaɪ̯s/
tartinades	/taʁt͡sɪnad/
tartinade	/taʁt͡sɪnad/
tchéquer	/tʃeke/
téteuses	/tetøz/
téteuse	/tetøz/
téteux	/tetø/
tiguidou	/t͡sɪɡɪdu/
tiper	/t͡sɪpe/
tips	/t͡sɪp/
tip	/t͡sɪp/
toé	/twɛ/
tofou	/tɑɔ̯fu/
touladis	/tʊlad͡zi/
touladi	/tʊlad͡zi/
tounes	/tun/
toune	/tun/
trails	/trajl/
trail	/trajl/
turlutaient	/t͡sʏʁlʏta/
turlutais	/t͡sʏʁlʏta/
turlutai	/t͡sʏʁlʏte/
turlutait	/t͡sʏʁlʏta/
turlutâmes	/t͡sʏʁlʏtam/
turlutant	/t͡sʏʁlʏtæ̃/
turlutassent	/t͡sʏʁlʏtas/
turlutasses	/t͡sʏʁlʏtas/
turlutasse	/t͡sʏʁlʏtas/
turlutassiez	/t͡sʏʁlʏtasje/
turlutassions	/t͡sʏʁlʏtasjõũ̯/
turlutas	/t͡sʏʁlʏtɔ/
turlutâtes	/t͡sʏʁlʏtat/
turluta	/t͡sʏʁlʏtɔ/
turlutât	/t͡sʏʁlʏtɔ/
turlutent	/t͡sʏʁlʏt/
turluteraient	/t͡sʏʁlʏtʁa/
turluterais	/t͡sʏʁlʏtʁa/
turluterai	/t͡sʏʁlʏtʁe/
turluterait	/t͡sʏʁlʏtʁa/
turluteras	/t͡sʏʁlʏtʁɔ/
turlutera	/t͡sʏʁlʏtʁɔ/
turlutèrent	/t͡sʏʁlʏtaʁ/
turluterez	/t͡sʏʁlʏtʁe/
turluteriez	/t͡sʏʁlʏtəʁje/
turluterions	/t͡sʏʁlʏtəʁjõũ̯/
turluterons	/t͡sʏʁlʏtʁõũ̯/
turluteront	/t͡sʏʁlʏtʁõũ̯/
turluter	/t͡sʏʁlʏte/
turlutes	/t͡sʏʁlʏt/
turlute	/t͡sʏʁlʏt/
turluté	/t͡sʏʁlʏte/
turlutez	/t͡sʏʁlʏte/
turlutiez	/t͡sʏʁlʏt͡sje/
turlutions	/t͡sʏʁlʏt͡sjõũ̯/
turlutons	/t͡sʏʁlʏtõũ̯/
U-turn	/jutœʁn/
U-turns	/jutœʁn/
watcher	/watʃe/
wipers	/wajpœʁ/, /wɪpœʁ/
wiper	/wajpœʁ/, /wɪpœʁ/, /wajpe/
zigonner	/ziɡɑɔ̯ne/
